NO ./xpm/north.xpm
SO ./xpm/south.xpm
WE ./xpm/west.xpm
EA ./xpm/east.xpm

F 07,142,35
C 0,178,238

1111111111111111111111111
111111111111111111111111111
10000000001100000111011111111
11111111111111111111111111111
11110111111111011100000010001
1111011111111101 101010010001
11000000110101011100000010001
1000000000000001100000011111
10000000000000001101010010001
11000001110101011111011110N01
1110111 1110101 101111010001
11111111 1111111 111111111111
