NO ./xpm/north.xpm
SO ./xpm/south.xpm
WE ./xpm/west.xpm
EA ./xpm/east.xpm

F 220,100,0
C 225,30,0


                 1111111111111111111
    1111111111111
1111111111111111111111111111111111111
                      111111111111111
111111111111111111111100000000W000001
11111111000000000000000101010101010111111111111
        11111111111111110101010101011111
                1111111101010101010111
                11000000000000000001
                1111111111111111111
            11111111
        1111
    1111
1111
