NO ./xpm/north.xpm
SO ./xpm/south.xpm
WE ./xpm/west.xpm
EA ./xpm/east.xpm

F 220,155,220
C 22,30,225


11111111111111111111111111111111111111111111
10E00000000000000000000100000000000000000001
10000000000000000000000100000000000000000001
10000000000000000000000100000000000000000001
10000000000000000000000100000000000000000001
10000000000000000000000000000000000000000001
10000000000000000000000100000000000000000001
10000000000000000000000100000000000000000001
111111111111111111111111111111111111111111111111111
